"filename", "language", "Rust", "comment", "blank", "total"
"c:\Users\samue\Documents\Rust Learning\rust-raytracer\src\camera.rs", "Rust", 57, 0, 7, 64
"c:\Users\samue\Documents\Rust Learning\rust-raytracer\src\color.rs", "Rust", 22, 1, 2, 25
"c:\Users\samue\Documents\Rust Learning\rust-raytracer\src\fps_counter.rs", "Rust", 34, 0, 4, 38
"c:\Users\samue\Documents\Rust Learning\rust-raytracer\src\main.rs", "Rust", 223, 12, 20, 255
"c:\Users\samue\Documents\Rust Learning\rust-raytracer\src\materials.rs", "Rust", 77, 0, 13, 90
"c:\Users\samue\Documents\Rust Learning\rust-raytracer\src\objects.rs", "Rust", 46, 0, 8, 54
"c:\Users\samue\Documents\Rust Learning\rust-raytracer\src\ray.rs", "Rust", 32, 0, 6, 38
"c:\Users\samue\Documents\Rust Learning\rust-raytracer\src\sphere.rs", "Rust", 48, 0, 8, 56
"c:\Users\samue\Documents\Rust Learning\rust-raytracer\src\util.rs", "Rust", 53, 0, 11, 64
"Total", "-", 592, 13, 79, 684